English term
Транскрипция
Русское название
accompany	[ tuː əˈkʌmpəni ]	аккомпанировать
accordion	[ əˈkɔːdjən ]	аккордеон
album	[ ˈælbəm ]	альбом
bagpipe	[ ˈbægpaɪp ]	волынка
balalaika	[ ˌbæləˈlaɪkə ]	балалайка
ballet	[ ˈbæleɪ ]	балет
band	[ bænd ]	группа
bass	[ beɪs ]	контрабас
bassoon	[ bə'suːn ]	фагот
baton	[ ˈbætən ]	дирижерская палочка
bow	[ baʊ ]	смычок
brass instruments	[ brɑːs 'ɪnstrəmənts ]	медные духовые инструменты
cello	[ ˈʧɛləʊ ]	виолончель
chamber music	[ ˈʧeɪmbə ˈmjuːzɪk ]	камерная музыка
clarinet	[ ˌklærɪˈnɛt ]	кларнет
classical music	[ ˈklæsɪkəl ˈmjuːzɪk ]	классическая музыка
compose	[ tuː kəmˈpəʊz ]	писать музыку
composer	[ kəmˈpəʊzə ]	композитор
concert	[ ˈkɒnsət ]	концерт
conductor	[ kənˈdʌktə ]	дирижер
cymbals	[ ˈsɪmbəlz ]	тарелки
drum	[ drʌm ]	барабан
drum sticks	[ drʌm stɪks ]	барабанные палочки
flute	[ fluːt ]	флейта
grand piano	[ grænd pɪˈænəʊ ]	рояль
guitar	[ gɪˈtɑː ]	гитара
harp	[ hɑːp ]	арфа
horn	[ hɔːn ]	рожок
instrumental music	[ ˌɪnstrʊˈmɛntl ˈmjuːzɪk ]	инструментальная музыка
loudspeaker	[ laʊdˈspiːkə ]	динамик, громкоговоритель
microphone	[ ˈmaɪkrəfəʊn ]	микрофон
musical instruments	[ 'mjuːzɪkl 'ɪnstrəmənts ]	музыкальные инструменты
musician	[ mjuːˈzɪʃən ]	музыкант
oboe	[ ˈəʊbəʊ ]	гобой
opera	[ ˈɒpərə ]	опера
operetta	[ ˌɒpəˈrɛtə ]	оперетта
orchestra	[ ˈɔːkɪstrə ]	оркестр
organ	[ ˈɔːgən ]	орган
percussion	[ pəˈkʌʃən ]	перкуссия, ударные инструменты
piano	[ pɪˈænəʊ ]	пианино
recital	[ rɪˈsaɪtl ]	сольный концерт
saxophone	[ ˈsæksəfəʊn ]	саксофон
single	[ ˈsɪŋgl ]	сингл – песня, выпущенная и продаваемая без альбома
soloist	[ ˈsəʊləʊɪst ]	солист
song	[ sɒŋ ]	песня
sound	[ saʊnd ]	звук
string instruments	[ strɪŋ 'ɪnstrəmənts ]	струнные инструменты
symphony	[ ˈsɪmfəni ]	симфония
synthesizer	[ ˈsɪnθɪˌsaɪzə ]	синтезатор
transcribe	[ tuː trænsˈkraɪb ]	записывать нотами
trombone	[ trɒmˈbəʊn ]	тромбон
trumpet	[ ˈtrʌmpɪt ]	труба
tuba	[ ˈtjuːbə ]	туба
video (clip)	[ ˈvɪdɪəʊ klɪp ]	видео-клип
viola	[ vɪˈəʊlə ]	альт
violin	[ ˌvaɪəˈlɪn ]	скрипка
virtuoso	[ ˌvɜːtjʊˈəʊzəʊ ]	виртуоз
wind instruments	[ wɪnd 'ɪnstrəmənts ]	духовые инструменты