Русское слово
English word
Транскрипция
части тела	parts of the body	
бедро	thigh, hip	[ θaɪ ] [ hɪp ]
большой палец	thumb	[ θʌm ]
бровь	eyebrow	[ ˈaɪbraʊ ]
висок	temple	[ ˈtempəl ]
волосы (волос)	hair	[ heə ]
глаз	eye	[ aɪ ]
голова	head	[ hed ]
горло	throat	[ θrəʊt ]
грудь	chest, breast, bosom, bust	[ tʃest ] [ brest ] [ ˈbʊzəm ] [ bʌst ]
желудок	stomach	[ ˈstʌmək ]
живот	belly, stomach	[ ˈbeli ] [ ˈstʌmək ]
губа	lip	[ lɪp ]
запястье	wrist	[ rɪst ]
зуб	tooth	[ tuːθ ]
кожа	skin	[ skɪn ]
кость	bone	[ bəʊn ]
кровь	blood	[ blʌd ]
лёгкое	lung	[ lʌŋ ]
лицо	face	[ feɪs ]
лоб	forehead	[ ˈfɒrɪd ]
локоть	elbow	[ ˈelbəʊ ]
мозг	brain	[ breɪn ]
нога	leg	[ leɡ ]
ноготь	(finger / toe)nail	[ ˈfɪŋɡə / təʊ neɪl ]
нос	nose	[ nəʊz ]
палец	finger	[ ˈfɪŋɡə ]
палец ноги	toe	[ təʊ ]
пах	groin	[ ɡrɔɪn ]
печень	liver	[ ˈlɪvə ]
плечо	shoulder	[ ˈʃəʊldə ]
подбородок	chin	[ tʃɪn ]
позвоночник	spine, backbone, spinal column	[ spaɪn ] [ ˈbækbəʊn ] [ ˈspaɪnəl ˈkɒləm ]
почка	kidney	[ ˈkɪdni ]
пятка	heel	[ hiːl ]
ресница	eyelash	[ ˈaɪlæʃ ]
рот	mouth	[ maʊθ ]
рука	hand; arm	[ hænd ] [ ɑːm ]
сердце	heart	[ hɑːt ]
скелет	skeleton	[ ˈskelɪtən ]
спина	back	[ ˈbæk ]
стопа	foot	[ fʊt ]
талия	waist	[ weɪst ]
тело	body	[ ˈbɒdi ]
усы	moustache	[ məˈstɑːʃ ]
ухо	ear	[ ɪə ]
челюсть	jaw(-bone)	[ dʒɔː bəʊn ]
череп	skull	[ skʌl ]
шея	neck	[ nek ]
щека	cheek	[ tʃiːk ]
язык	tongue	[ tʌŋ ]
болезни / телесные повреждения	diseases / injuries	
аллергическая реакция	allergic reaction	[ əˈlɜːdʒɪk rɪˈækʃən ]
аллергия	allergy	[ ˈælədʒi ]
амнезия; потеря памяти	amnesia, memory loss	[ æmˈniːziə ] [ ˈmeməri lɒs ]
ангина	quinsy, sore throat	[ ˈkwɪnzi ] [ sɔː θrəʊt ]
аппендицит	appendicitis	[ əˌpendəˈsaɪtɪs ]
артрит	arthritis	[ ɑːˈθraɪtɪs ]
астма	asthma	[ ˈæsmə ]
бессонница	insomnia	[ ɪnˈsɒmnɪə ]
бешенство	rabies	[ ˈreɪbiːz ]
болезнь	illness, sickness, disease	[ ˈɪlnəs ] [ ˈsɪknəs ] [ dɪˈziːz ]
- заразная ~	contagious ~	[ kənˈteɪdʒəs ]
- излечимая ~	curable ~	[ ˈkjʊərəbəl ]
- неизлечимая ~	incurable ~	[ ɪnˈkjʊərəbəl ]
- смертельная ~	fatal, deadly ~	[ ˈfeɪtəl ] [ ˈdedli ]
- хроническая ~	chronic ~	[ ˈkrɒnɪk ]
болезнь Альцгеймера	Alzheimer's disease	[ æ̱lts’haɪməz dɪ’ziːz ]
болезнь сердца	heart disease	[ hɑːt dɪˈziːz ]
больное горло, боль в горле	a sore throat	[ ə sɔː θrəʊt ]
боль в груди	chest pain	[ tʃest peɪn ]
боль в животе	stomachache	[ stomachache ]
боль в спине	backache	[ ˈbækeɪk ]
боль в ухе	earache	[ ˈɪəreɪk ]
больничный (отпуск по болезни)	sick leave	[ sɪk liːv ]
больной	ill, sick, diseased	[ ɪl ] sɪk ] [ dɪˈziːzd ]
бородавка	wart	[ wɔːt ]
бронхит	bronchitis	[ brɒŋˈkaɪtɪs ]
брюшной тиф	typhoid fever	[ ˈtaɪfɔɪd ˈfiːvə ]
венерическая инфекция	STI (sexually transmitted infection)	[ ˈsekʃʊəli trænzˈmɪtɪd ɪnˈfekʃən ]
ветряная оспа	chicken pox, chickenpox	[ ˈtʃɪkɪn pɒks ] [ ˈtʃɪkɪnpɒks ]
вирус	virus	[ ˈvaɪərəs ]
ВИЧ	HIV (human immunodeficiency virus)	[ ˌeɪtʃaɪˈviː ] [ ˈhjuːmən ɪˌmjuːnəʊdɪˈfɪʃnsi ˈvaɪərəs ]
воспаление	inflammation	[ ˌɪnfləˈmeɪʃən ]
воспаление легких	pneumonia	[ njuːˈməʊnɪə ]
воспаление миндалин, тонзиллит	tonsillitis, inflammation of the tonsils	[ ˌtɒnsɪˈlaɪtɪs ] [ ˌɪnfləˈmeɪʃən əv ðə ˈtɒnsɪlz ]
вросший ноготь на пальце ноги	ingrown toenail	[ ˈɪnɡrəʊɪŋ ˈtəʊneɪl ]
выздороветь	to recover	[ tə rɪˈkʌvə ]
выкидыш	miscarriage	[ ˌmɪsˈkærɪdʒ ]
высокое кровяное давление	high blood pressure, hypertension	[ haɪ blʌd ˈpreʃə ] [ ˌhaɪpəˈtenʃən ]
гастрит	gastritis	[ ɡæˈstraɪtɪs ]
гемофилия	haemophilia	[ ˌhiːməˈfɪlɪə ]
геморрой	haemorrhoids, piles	[ ˈhemərɔɪdz ] [ paɪlz ]
гепатит	hepatitis	[ ˌhepəˈtaɪtɪs ]
герпес	herpes	[ ˈhɜːpiːz ]
гипотермия; переохлаждение	hypothermia, exposure to cold	[ ˌhaɪpəˈθɜːmiə ] [ ɪkˈspəʊʒə tə kəʊld ]
глухой	deaf	[ def ]
головная боль	headache	[ ˈhedeɪk ]
головокружение	giddiness, dizziness, vertigo	[ ˈɡɪdɪnəs ] [ ˈdɪzɪnəs ] [ ˈvɜːtɪɡəʊ ]
горная болезнь	mountain sickness, altitude sickness	[ ˈmaʊntɪn ˈsɪknəs ] [ ˈæltɪtjuːd ˈsɪknəs ]
грибок	fungus	[ ˈfʌŋɡəs ]
грипп	flu, influenza	[ fluː ] [ ˌɪnflʊˈenzə ]
грыжа	hernia, rupture	[ ˈhɜːnɪə ] [ ˈrʌptʃə ]
депрессия	depression	[ dɪˈpreʃən ]
диабет	diabetes	[ ˌdaɪəˈbiːtɪz ]
диагноз	diagnosis	[ ˌdaɪəɡˈnəʊsɪs ]
диарея	diarrhea, diarrhea	[ ˌdaɪəˈrɪə ] [ ˌdaɪəˈrɪə ]
дизентерия	dysentery	[ ˈdɪsəntri ]
дислексия, неспособность к чтению	dyslexia	[ dɪsˈleksɪə ]
дифтерия	diphtheria	[ dɪfˈθɪərɪə ]
жёлтая лихорадка	yellow fever	[ ˌjeləu'fiːvə ]
желтуха	jaundice	[ ˈdʒɔːndɪs ]
заболевать / заболеть	to fall ill (with), to be taken ill (with), to be down (with)	[ tə fɔːl ɪl wɪð ] [ tə bi ˈteɪkən ɪl wɪð ] [ tə bi daʊn wɪð ]
заноза	splinter	[ ˈsplɪntə ]
запор	constipation	[ ˌkɒnstɪˈpeɪʃən ]
заразный	infectious, contagious	[ ɪnˈfekʃəs ] [ kənˈteɪdʒəs ]
изжога	heartburn	[ ˈhɑːtbɜːn ]
инсульт	stroke, apoplexy, cerebrovascular accident	[ strəʊk ] [ ˈæpəpleksi ] [ ˌsɛrɪbrəʊˈvaskjʊləˈæksɪdənt ]
инфаркт	infarction, heart attack	[ ɪnˈfɑːkʃən ] [ hɑːt əˈtæk ]
инфекция	infection	[ ɪnˈfekʃən ]
кашель	cough	[ kɒf ]
кишечная палочка	Escherichia coli	[ ˌɛʃɨˈrɪkiə ˈkoʊlaɪ ]
коклюш	whooping cough	[ ˈhuːpɪŋ kɒf ]
конъюнктивит	conjunctivitis	[ kənˌdʒʌŋktɪˈvaɪtɪs ]
корь	measles	[ ˈmiːzlz ]
кровотечение	bleeding	[ ˈbliːdɪŋ ]
кровотечение из носа	nosebleed	[ ˈnəʊzbliːd ]
лейкемия, лейкоз	leukemia, leukosis	[ luːˈkiːmiə ] [ˈljuːkəusɪs ]
малярия	malaria	[ məˈleərɪə ]
менингит	meningitis	[ ˌmenɪnˈdʒaɪtɪs ]
мигрень	migraine	[ ˈmiːɡreɪn ]
мозоль	callus, corn	[ ˈkæləs ] [ kɔːn ]
мононуклеоз инфекционный	glandular fever, kissing disease	[ ˈɡlændjʊlə ˈfiːvə ] [ ˈkɪsɪŋ dɪˈziːz ]
нарыв, абсцесс, гнойник	abscess, boil	[ ˈæbses ] [ bɔɪl ]
насморк	(head) cold, cold in the head, running nose	[ hed kəʊld ] kəʊld ɪn ðə hed ] [ ˈrʌnɪŋ nəʊz ]
недомогание	ailment, malaise	[ ˈeɪlmənt ] [ mæˈleɪz ]
несварение желудка; нарушение пищеварения	indigestion	[ ˌɪnd(a)ɪˈdʒestʃən ]
низкое кровяное давление	low blood pressure, hypotension	[ ləʊ blʌd ˈpreʃə ] [ ˌhaɪpoˈtenʃən ]
обезвоживание	dehydration	[ diːˈhaɪdreɪʃən ]
облысение	hair loss, alopecia, baldness	[ heə lɒs ] [ˌæləu'piːʃə ] [ bɔːldnəs ]
обморожение	frostbite	[ ˈfrɒstbaɪt ]
обморок	faint, fainting fit	[ feɪnt ] [ ˈfeɪntɪŋ fɪt ]
ожирение	obesity	[ əʊˈbiːsɪti ]
опухоль	swelling, tumor	[ ˈswelɪŋ ] [ ˈtuːmə ]
осложнение болезни	complication of the disease	[ ˌkɒmplɪˈkeɪʃən əv ðə dɪˈziːz ]
паралич	paralysis	[ pəˈræləsɪs ]
перелом	fracture	[ ˈfræktʃə ]
перитонит	peritonitis	[ ˌperɪtəˈnaɪtɪs ]
пищевое отравление	food poisoning	[ fuːd ˈpɔɪzənɪŋ ]
пневмония	pneumonia	[ njuːˈməʊnɪə ]
подагра	gout	[ ɡaʊt ]
полиомиелит	polio	[ ˈpəʊlɪəʊ ]
понос	diarrhea, diarrhoea	[ ˌdaɪəˈrɪə ] [ ˌdaɪəˈrɪə ]
порез	cut	[ kʌt ]
порезаться	to cut oneself	[ tə kʌt wʌnˈself ]
припадок	fit, attack	[ fɪt ] [ əˈtæk ]
- нервный припадок	fit / attack of nerves, nervous fit	[ fɪt əˈtæk əv nɜːvz ] [ ˈnɜːvəs fɪt ]
простуда	cold	[ kəʊld ]
простудиться	to catch / take (a) cold / chill	[ tə kætʃ teɪk ə kəʊld tʃɪl ]
прыщ	spot, pimple	[ spɒt ] [ ˈpɪmpl ]
рак	cancer	[ ˈkænsə ]
рак лёгких	lung cancer	[ lʌŋ ˈkænsə ]
расстройство желудка	indigestion, stomach upset	[ ˌɪndɪˈdʒestʃən ] [ ˈstʌmək ˌʌpˈset ]
расстройство питания	eating disorder	[ ˈiːtɪŋ dɪsˈɔːdə ]
растяжение связок	sprain	[ spreɪn ]
ревматизм	rheumatism	[ ˈruːmətɪzəm ]
свинка	mumps	[ mʌmps ]
сенная лихорадка	hay fever	[ heɪ ˈfiːvə ]
сердечный приступ	heart attack	[ hɑːt əˈtæk ]
синяк	bruise	[ bruːz ]
скарлатина	scarlet fever	[ ˈskɑːlət ˈfiːvə ]
склероз	sclerosis	[ skləˈrəʊsɪs ]
- рассеянный склероз	multiple sclerosis (MS)	[ ˈmʌltɪpəl skləˈrəʊsɪs ]
сломать ногу	to break one's leg	[ tə breɪk wʌnz leɡ ]
сломанная (сломанная кость, ~ рука, ~ нога)	broken (broken bone, broken arm, broken leg)	[ ˈbrəʊkən ] [ˈbrəʊkən bəʊn ] [ ˈbrəʊkən ɑːm ] [ ˈbrəʊkən leɡ ]
солнечный ожог	sunburn	[ ˈsʌnbɜːn ]
солнечный удар	sunstroke	[ ˈsʌnstrəʊk ]
сотрясение мозга	brain concussion	[ breɪn kənˈkʌʃən ]
СПИД	AIDS (acquired immunodeficiency syndrome)	[ eɪdz ] [ əˈkwaɪəd ɪˌmjuːnəʊdɪˈfɪʃnsi ˈsɪndrəʊm ]
старческое слабоумие	senile dementia	[ ˈsiːnaɪl dɪˈmenʃə ]
стенокардия, грудная жаба	angina	[ æn'ʤaɪnə ]
столбняк	tetanus	[ 'tetənəs ]
стресс	stress	[ stres ]
судорога, спазм	cramp, convulsion, spasm	[ kræmp ] [ kənˈvʌlʃən ] [ ˈspæzəm ]
сыпь	rash, (skin) eruption	[ ræʃ ] [ skɪn ɪˈrʌpʃən ]
телесное повреждение	injury	[ ˈɪndʒəri ]
температура	temperature, fever	[ ˈtemprətʃə ] [ ˈfiːvə ]
тепловой удар	heat stroke	[ hiːt strəʊk ]
тиф брюшной	typhoid fever	[ ˈtaɪfɔɪd ˈfiːvə ]
токсоплазмоз (паразитарная болезнь)	toxoplasmosis	[ˌtɒksəʊplazˈməʊsɪs]
туберкулез	tuberculosis	[ tju:ˌbɜːkjʊˈləʊsɪs ]
угорь	acne	[ ˈækni ]
усталость	fatigue	[ fəˈtiːɡ ]
холера	cholera	[ ˈkɒlərə ]
царапина	scratch	[ skrætʃ ]
чесотка	scabies	[ ˈskeɪbiːz ]
чувство тошноты	nausea	[ ˈnɔːzɪə ] [ ˈnɔːsɪə ]
чума	plague	[ pleɪg ]
шизофрения	schizophrenia	[ ˌskɪtsəʊˈfriːnɪə ]
шишка (опухоль)	swelling, bump	[ ˈswelɪŋ ] [ bʌmp ]
шрам	scar	[ skɑː ]
экзема	eczema	[ ˈeksɪmə ]
энцефалит (клещевой)	(tick-borne) encephalitis	[ tɪk bɔːn ] [ ˌensefə'laɪtɪs ], [ˌenke- ], [ɪn-]
эпидемия	epidemic	[ ˌepɪˈdemɪk ]
эпилепсия	epilepsy	[ ˈepɪlepsi ]
язва	ulcer	[ ˈʌlsə ]
язва желудка	gastric ulcer, stomach ulcer	[ ˈɡæstrɪk ˈʌlsə ] [ ˈstʌmək ˈʌlsə ]
симптомы / жалобы / рекомендации	symptoms / complaints / recommendations	
беременная	pregnant	[ ˈpreɡnənt ]
бледный	pale, pallid	[ peɪl ] [ ˈpælɪd ]
боль	pain, ache	[ peɪn ] [ eɪk ]
бросать / бросить курить	to give up smoking, to stop / quit smoking	[ tə ɡɪv ʌp ˈsməʊkɪŋ ] [ tə stɒp / kwɪt ˈsməʊkɪŋ ]
в хорошей форме	fit, in good shape	[ fɪt ] [ ɪn ɡʊd ʃeɪp ]
дышать	to breathe	[ tə briːð ]
заплакать	to start / begin to cry, to start crying	[ tə stɑːt / bɪˈɡɪn tə kraɪ ] [ tə stɑːt ˈkraɪɪŋ ]
здоровый	healthy	[ ˈhelθi ]
здоровье	health	[ helθ ]
курить	to smoke	[ tə sməʊk ]
недееспособный (инвалид)	disabled, handicapped	[ dɪsˈeɪbəld ] [ ˈhændɪkæpt ]
отдыхать / отдохнуть	to (have a) rest	[ tə həv ə rest ]
падать / упасть в обморок	to faint, to swoon	[ tə feɪnt ] [ tə swuːn ]
пот	sweat, perspiration	[ swet ] [ ˌpɜːspəˈreɪʃən ]
пульс	pulse	[ pʌls ]
реабилитация	rehabilitation	[ ˌriːəˌbɪlɪˈteɪʃən ]
слабый	weak, feeble	[ wiːk ] [ ˈfiːbəl ]
слепой	blind	[ blaɪnd ]
советоваться с врачом	to consult a doctor	[ tə kənˈsʌlt ə ˈdɒktə ]
страдать	to suffer (from)	[ tə ˈsʌfə frɒm ]
у меня болит голова	I have a headache	[ ˈaɪ həv ə ˈhedeɪk ]
у меня болит горло	I have a sore throat	[ ˈaɪ həv ə sɔː θrəʊt ]
у меня болит зуб	I have (a) toothache	[ ˈaɪ həv ə ˈtuːθeɪk ]
умирать / умереть	to die	[ tə daɪ ]
утешать	to comfort, to console	[ tə ˈkʌmfət ] [ tə kənˈsəʊl ]
чувствовать себя хорошо	to feel well / good	[ tə fiːl wel / ɡʊd ]
лекарственные средства и прочее	medicines, etc.	
бинт	bandage	[ ˈbændɪdʒ ]
болеутоляющее средство	painkiller	[ ˈpeɪnkɪlə ]
вредный	harmful, injurious (to health)	[ ˈhɑːmfəl ] [ ɪnˈdʒʊərɪəs tə helθ ]
доза	dose	[ dəʊs ]
костыль	crutch	[ krʌtʃ ]
лекарство	medicine, drug	[ ˈmedsən ] [ drʌɡ ]
лекарство от кашля	cough medicine	[ kɒf ˈmedsən ]
лечение	(medical) treatment	[ ˈmedɪkəl ˈtriːtmənt ]
машина скорой помощи	ambulance	[ ˈæmbjələns ]
операция	operation, surgery	[ ˌɒpəˈreɪʃən ] [ ˈsɜːdʒəri ]
очки	glasses, spectacles	[ ˈɡlɑːsɪz ] [ ˈspektəkəlz ]
отрава, яд	poison	[ ˈpɔɪzən ]
пациент(ка)	patient	[ ˈpeɪʃnt ]
перевязь, повязка	sling	[ slɪŋ ]
пластырь	(sticking) plaster	[ ˈstɪkɪŋ ˈplɑːstə ]
побочное действие	side-effect	[ saɪd ɪˈfekt ]
принимать / принять лекарство	to take (some) medicine	[ tə teɪk səm ˈmedsən ]
медицина	medicine, medical science	[ ˈmedsən ] [ ˈmedɪkəl ˈsaɪəns ]
медсестра	nurse	[ nɜːs ]
противозачаточная пилюля	contraceptive pill	[ ˌkɒntrəˈseptɪv pɪl ]
рентген	X-ray	[ ˈeks reɪ ]
рецепт (мед.)	prescription	[ prɪˈskrɪpʃən ]
снотворная таблетка	sleeping tablet / pill	[ ˈsliːpɪŋ ˈtæblɪt / pɪl ]
средство	remedy, cure	[ ˈremədi ] [ kjʊə ]
таблетка	tablet, pill	[ ˈtæblɪt ] [ pɪl ]
термометр	thermometer	[ θəˈmɒmɪtə ]
шприц	syringe	[ sɪˈrɪndʒ ]
хирургия	surgery	[ ˈsɜːdʒəri ]