English term
Transcription
Русское название
absorber, bumper	[ əbˈzɔːbə ] [ ˈbʌmpə ]	бампер
accelerator	[ əkˈseləreɪtə ]	акселератор
accumulator, battery	[ əˈkjuːmjəleɪtə ] [ ˈbætri ]	аккумулятор
armrest	[ ˈɑːmrest ]	подлокотник
back door	[ bæk ˈdɔ: ]	задняя дверь
bonnet (BrE), hood (AmE)	[ ˈbɒnɪt ] [ hʊd ]	капот
boot	[ buːt ]	багажник
brake	[ breɪk ]	тормоз
brake fluid	[ breɪk ˈfluːɪd ]	тормозная жидкость
brake light	[ breɪk laɪt ]	стоп-сигнал
bulbs	[ bʌlbz ]	лампы
bumper	[ ˈbʌmpə ]	бампер
cab	[ kæb ]	кабина
car, automobile	[ kɑː ] [ ˈɔːtəməʊˌbiːl ]	машина, автомобиль
car alarm	[ kɑːr əˈlɑːm ]	автосигнализация
carburettor	[ ˌkɑːbəˈretə ]	карбюратор
chassis	[ ˈʃæsi ]	шасси
clutch	[ klʌtʃ ]	сцепление
cooling system	[ ˈkuːlɪŋ ˈsɪstəm ]	система охлаждения
crankshaft	[ ˈkrænkʃɑːft ]	коленчатый вал
cylinder	[ ˈsɪlɪndə ]	цилиндр
dashboard	[ ˈdæʃbɔːd ]	приборная панель
diesel	[ ˈdiːzl̩ ]	дизельное топливо
driver's license	[ ˈdraɪvərz ˈlaɪsns ]	водительское удостоверение
electrical system	[ ɪˈlektrɪkl ˈsɪstəm ]	электрооборудование
engine	[ ˈendʒɪn ]	двигатель
exhaust (pipe)	[ ɪɡˈzɔːst paɪp ]	выхлопная труба
fan belt	[ fæn belt ]	ремень охлаждения
fender, wing	[ ˈfendə ] [ wɪŋ ]	крыло автомобиля
filling station	[ ˈfɪlɪŋ ˈsteɪʃn̩ ]	азс
fog lights	[ fɒɡ laɪts ]	противотуманные фары
front door	[ frʌnt dɔː ]	передняя дверь
fuel gauge	[ ˈfjuːəl ɡeɪdʒ ]	указатель уровня топлива
garage	[ ˈɡærɑːʒ ]	гараж
gear	[ ɡɪə ]	передача
gear-change shift lever	[ ɡɪə tʃeɪndʒ ʃɪft ˈliːvə ]	рычаг переключения передач
handbrake	[ ˈhændbreɪk ]	ручной тормоз
hatchback	[ ˈhætʃbæk ]	хэчбэк
headlights	[ ˈhedlaɪts ]	фары
headrest	[ ˈhedrest ]	подголовник
highway	[ ˈhaɪweɪ ]	автострада
hood (AmE), bonnet (BrE)	[ hʊd ] [ ˈbɒnɪt ]	капот
horn	[ hɔːn ]	сигнал
hubcap	[ ˈhʌbkæp ]	колпак (колеса)
ignition	[ ɪɡˈnɪʃən ]	зажигание
jack	[ dʒæk ]	домкрат
license plate	[ ˈlaɪsns pleɪt ]	номерной знак
lorry, truck	[ ˈlɒri ] [ trʌk ]	грузовик
number plate	[ ˈnʌmbə pleɪt ]	номерной знак
oil	[ ɔɪl ]	масло
oil pump	[ ɔɪl pʌmp ]	масляный насос
parking light	[ ˈpɑːkɪŋ laɪt ]	габаритные огни
pedal	[ ˈpedl̩ ]	педаль
petrol	[ ˈpetrəl ]	бензин
pump	[ pʌmp ]	насос
radiator	[ ˈreɪdɪeɪtə ]	радиатор
rearview mirror	[ ˈrɪrvjuː ˈmɪrə ]	зеркало заднего вида
road	[ rəʊd ]	дорога
screwdriver	[ ˈskruːdraɪvə ]	отвертка
seatbelt	[ ˈsiːtˌbelt ]	ремень безопастности
sedan	[ sɪˈdæn ]	седан
service station	[ ˈsɜːvɪs ˈsteɪʃn̩ ]	станция тех обслуживания
signal	[ ˈsɪɡnəl ]	указатель поворота
spanner	[ ˈspænə ]	гаечный ключ
spare parts	[ speə pɑːts ]	запчасти
spark plug	[ spɑːk plʌɡ ]	свеча
speedometer	[ spiːˈdɒmɪtə ]	спидометр
spring	[ sprɪŋ ]	рессора
starter	[ ˈstɑːtə ]	стартер
steering wheel	[ ˈstɪərɪŋ wiːl ]	рулевое колесо
suspension	[ səˈspenʃn̩ ]	подвеска
tail-light	[ ˈteɪl laɪt ]	задний фонарь
tank	[ tæŋk ]	бензобак
temperature gauge	[ ˈtemprətʃə ɡeɪdʒ ]	датчик температуры
tyre (BrE), tire (AmE)	[ ˈtaɪə ] [ ˈtaɪər ]	шина
tool	[ tuːl ]	инструмент
trailer	[ ˈtreɪlə ]	прицеп
transmission, gear box	[ trænzˈmɪʃn̩ ] [ ɡɪə bɒks ]	коробка передач
trunk	[ trʌŋk ]	багажник
van	[ væn ]	автофургон
wheel	[ wiːl ]	колесо
window roller	[ ˈwɪndəʊ ˈrəʊlə ]	стеклоподъёмник
windscreen, windshield	[ wɪndskriːn ] [ ˈwɪndʃiːld ]	ветровое стекло
windscreen wiper	[ ˈwɪndskriːn ˈwaɪpə ]	дворники