Русское слово
English Word
Transcription
аптека	chemist's (shop)	[ ˈkemɪsts ] [ ʃɒp ]
арка	arch	[ ɑːtʃ ]
банк	bank	[ bæŋk ]
бар	bar	[ bɑː ]
бассейн	swimming pool / baths	[ ˈswɪmɪŋ puːl ] [ bɑːðz ]
библиотека	library	[ ˈlaɪbrəri ]
больница	hospital	[ ˈhɒspɪtl̩ ]
булочная	bakery, baker's (shop)	[ ˈbeɪkəri ] [ ˈbeɪkəz ʃɒp ]
бюро находок	lost property office	[ lɒst ˈprɒpəti ˈɒfɪs ]
витрина	(shop) window	[ ʃɒp ˈwɪndəʊ ]
ворота	gate(s)	[ ɡeɪt ˈes ]
впечатляющий	impressive	[ ɪmˈpresɪv ]
вход	entrance, way in	[ ɪnˈtrɑːns ] [ ˈweɪ ɪn ]
выбирать / выбрать	to choose, to select, to pick	[ tə tʃuːz ] [ tə sɪˈlekt ] [ tə pɪk ]
высококачественный	high-quality	[ haɪ ˈkwɒlɪti ]
выход	exit, way out	[ ˈeksɪt ] [ ˈweɪ aʊt ]
галерея	gallery	[ ˈɡæləri ]
гастроном	grocer's / grocery (shop)	[ ˈɡrosərz ] [ ˈɡrəʊsəri ʃɒp ]
гулять / погулять	to (go for a) walk / stroll	[ tə ɡəʊ fər ə wɔːk ] [ strəʊl ]
движение	traffic	[ ˈtræfɪk ]
делать / сделать покупки	to shop, to go shopping	[ tə ʃɒp ] [ tə ɡəʊ ˈʃɒpɪŋ ]
денежный автомат	cash machine / dispenser	[ kæʃ məˈʃiːn ] [ dɪˈspensə ]
деньги	money	[ ˈmʌni ]
дешёвый	cheap	[ tʃiːp ]
дорога	road	[ rəʊd ]
дорогой	dear (чувства), expensive (стоимость)	[ dɪə ] [ ɪkˈspensɪv ]
дорожный знак	road sign	[ rəʊd saɪn ]
заблудиться	to get lost, to lose one's way	[ tə ˈɡet lɒst ] [ tə luːz wʌnz ˈweɪ ]
затор	traffic jam, congestion	[ ˈtræfɪk dʒæm ] [ kənˈdʒestʃən ]
здание	building	[ ˈbɪldɪŋ ]
зоопарк	zoo	[ zuː ]
игрушечный магазин	toyshop	[ ˈtɔɪʃɒp ]
искать	to look for, search for, to seek	[ tə lʊk fɔː ] [ sɜːtʃ fɔː ] [ tə siːk ]
касса	checkout, cash-desk; till, cash register	[ ˈtʃekaʊt ] [ kæʃ desk ] [ tɪl ] [ kæʃ ˈredʒɪstə ]
кафе	cafe / cafe	[ ˈkæfeɪ ]
квитанция (чек)	receipt	[ rɪˈsiːt ]
кино	cinema	[ ˈsɪnəmə ]
киоск	stall	[ stɔːl ]
клумба	flower-bed	[ ˈflaʊəbed ]
книжный магазин	bookshop	[ ˈbʊkʃɒp ]
кредитная карточка	credit card	[ ˈkredɪt kɑːd ]
лифт	lift	[ lɪft ]
магазин	shop	[ ʃɒp ]
мелочь	(small) change	[ smɔːl tʃeɪndʒ ]
мечеть	mosque	[ mɒsk ]
монета	coin	[ kɔɪn ]
мост	bridge	[ brɪdʒ ]
музей	museum	[ mjuːˈzɪəm ]
мясной магазин	butcher's (shop)	[ ˈbʊtʃərz ʃɒp ]
на втором этаже	on the first floor (second storey)	[ ɒn ðə ˈfɜːst flɔː] [ˈsekənd ˈstɔːri ]
на первом этаже	on the ground floor (first storey)	[ ɒn ðə ɡraʊnd flɔː ] [ ˈfɜːst ˈstɔːri ]
налево	on / to the left	[ ɒn ] [ tə ðə left ]
направо	on / to the right	[ ɒn ] [ tə ðə raɪt ]
находить/найти	to find	[ tə faɪnd ]
новый	new	[ njuː ]
ночной клуб	nightclub	[ ˈnaɪtklʌb ]
обувной магазин	shoe shop	[ ʃuː ʃɒp ]
памятник	memorial, monument	[ mɪˈmɔːrɪəl ] [ ˈmɒnjʊmənt ]
парикмахерская	hairdresser's, hair salon	[ ˈheədresəɪz ] [ heə ˈsælɒn ]
парк	park	[ pɑːk ]
перекрёсток	crossroads, junction	[ ˈkrɒsrəʊdz ] [ ˈdʒʌŋkʃn̩ ]
переход (зебра)	(pedestrian) crossing (zebra crossing)	[ pɪˈdestrɪən ˈkrɒsɪŋ ] [ ˈzebrə ˈkrɒsɪŋ ]
перейти (через) улицу	to cross the street / road	[ tə krɒs ðə striːt ] [ rəʊd ]
пешеход	pedestrian	[ pɪˈdestrɪən ]
план города	town plan, street map	[ taʊn plæn ] [ striːt mæp ]
платить / заплатить (за что)	to pay (for)	[ tə peɪ fɔː ]
платить / заплатить наличными	to pay (in) cash	[ tə peɪ ɪn kæʃ ]
площадь	(town) square	[ taʊn skweə ]
подарок	present, gift	[ prɪˈzent ] [ ɡɪft ]
подержанный	second-hand	[ ˈsekənd hænd ]
подземный переход	underpass, subway	[ ˈʌndəpɑːs ] [ ˈsʌbweɪ ]
пожарное депо	fire station	[ ˈfaɪə ˈsteɪʃn̩ ]
покупатель	buyer, purchaser; customer	[ ˈbaɪə ] [ ˈpɜːtʃəsə ] [ ˈkʌstəmə ]
покупать / купить	to buy, to purchase	[ tə baɪ ] [ tə ˈpɜːtʃəs ]
получить	to receive	[ tə rɪˈsiːv ]
послать письмо	to send / post a letter	[ tə send ] ] pəʊst ə ˈletə ]
почта	post office	[ pəʊst ˈɒfɪs ]
почтовый ящик	postbox, pillar box	[ ˈpəʊstbɒks ] [ ˈpɪlə bɒks ]
прилавок	counter	[ ˈkaʊntə ]
примерочная	fitting / changing room	[ ˈfɪtɪŋ ] [ ˈtʃeɪndʒɪŋ ruːm ]
примерять	to try on	[ tə traɪ ɒn ]
продавать	to sell	[ tə sel ]
распродажа	(clearance) sale	[ ˈklɪərəns seɪl ]
ресторан	restaurant	[ ˈrestrɒnt ]
рыбный магазин	fish shop, fishmonger's (shop)	[ fɪʃ ʃɒp ] [ ˈfɪʃmʌŋɡəɪz ʃɒp ]
рынок	market	[ ˈmɑːkɪt ]
светофор	(set of) traffic lights	[ set əv ˈtræfɪk laɪts ]
синагога	synagogue	[ ˈsɪnəɡɒɡ ]
скамья	bench, seat	[ bentʃ ] [ siːt ]
скидка	discount, (price) reduction	[ ˈdɪskaʊnt ] [ praɪs rɪˈdʌkʃn̩ ]
собор	cathedral	[ kəˈθiːdrəl ]
стадион	stadium	[ ˈsteɪdɪəm ]
статуя	statue	[ ˈstætʃuː ]
стоить	to cost	[ tə kɒst ]
стоянка машин	car park	[ kɑː pɑːk ]
стоянка такси	taxi-rank	[ ˈtæksi ræŋk ]
стоять в очереди	to queue up (for)	[ tə kjuː ʌp fɔː ]
театр	theatre	[ ˈθɪətə ]
торговаться (с кем-л.)	to bargain / haggle (with)	[ tə ˈbɑːɡɪn ] [ ˈhæɡl̩ wɪð ]
торговый центр	shopping centre	[ ˈʃɒpɪŋ ˈsentə ]
тротуар (мостовая)	pavement	[ ˈpeɪvmənt ]
тупик	dead end, blind alley	[ ded end ] [ blaɪnd ˈæli ]
угол	corner	[ ˈkɔːnə ]
узкий	narrow	[ ˈnærəʊ ]
улица	street	[ striːt ]
универмаг	department store	[ dɪˈpɑːtmənt stɔː ]
универсам	supermarket	[ ˈsuːpəmɑːkɪt ]
уставать	to get / grow tired	[ tə ˈɡet ] [ ɡrəʊ ˈtaɪəd ]
фонтан	fountain	[ ˈfaʊntɪn ]
цена	price, cost	[ praɪs ] [ kɒst ]
церковь	church	[ tʃɜːtʃ ]
цирк	circus	[ ˈsɜːkəs ]
чек (банковский)	cheque	[ tʃek ]
чековая книжка	chequebook	[ ˈtʃekbʊk ]
широкий	wide, broad	[ waɪd ] [ brɔːd ]
эскалатор	escalator	[ ˈeskəleɪtə ]
этаж	floor, storey	[ flɔː ] [ ˈstɔːri ]
ювелирный магазин	jeweller's (shop), jewellery shop	[ ˈdʒuːələɪz ʃɒp ] [ ˈdʒuːəlri ʃɒp ]